  NO ./textures/wall.xpm          
EA ./textures/wall2.xpm          

    SO ./textures/wall3.xpm

WE ./textures/wall4.xpm


F 0,200,100
C 50,30,150

                          1
       01111111111111111110111111111
       10000000001100000220000011
       101100000111000002000000101
       10000000000000002020000011  111
111111111011000001110000200000001  101
100000000011000001010111111111111
11110111111111011110000010001
11110111011111011101010010001
11000000110101011100000000001
10000000000000001100000010001
1N002000000000001101010010001
10000001110101011111011210001
 1110111 1110101 101111010001
11111111 1111111 111111111111
1                            1
111111111111111111111111111111
111111111111111111111111111111
