    NO ./textures/wall.xpm
EA ./textures/wall2.xpm
SO    ./textures/wall3.xpm  
WE ./textures/wall4.xpm
F 0,255,0,3
C 225,30,0
       01111111111111111111111111111
       1000000000110000000000001
       1011000001110000020000001
       10000000000000002N2000001
111111111011000001110000200000001
100000000011000001110111111111111
11110111111111011100000010001
11110111011111011101010010001
11000000110101011100000000001
10000000000000001100000010001
10000000000000001101010010001
11000001110101011111011210001
11110111 1110101 101111010001
11110111 1111111 111111011111
1                            1
111111111111111111111111111111
                               
                                