    NO ./images/all_walls.png
EA ./images/all_walls.png
SO    ./images/all_walls.png   
WE ./images/all_walls.png
F 220,100,0
C 225,30,0
       01111111111111111111111111111
       1000000000110000000000001
       1011000001110000000000001
       1001000000000000000000001
111111111011000001110000000000001
100000000011000001110111111111111
11110111111111011100000010001
11110111011111011101010010001
11000000110101011100000000001
10000000000000001100000010001
10000000000000001101010010001
11000001110101011111011110N01
11110111 1110101 101111010001
11110111 1111111 111111111111
1                            1
111111111111111111111111111111
                               
                                 
