NO ./path_to_the_north_texture
SO ./path_to_the_south_texture
WE ./path_to_the_west_texture
EA ./path_to_the_east_texture
F 220,100,0
C 225,30,0

111111111111111111
100000110000000001
10N000000000001001
110011110000000001
111111110001010101
100000000000000001
111111111111111111